9x9
l ,n ,s ,g ,k ,g ,s ,n ,l
_ ,r ,_ ,_ ,_ ,_ ,_ ,b ,_
p ,_ ,p ,p ,p ,p ,p ,_ ,p
_ ,p ,_ ,_ ,_ ,_ ,_ ,p ,_
_ ,_ ,_ ,_ ,_ ,_ ,_ ,_ ,_
_ ,P ,_ ,_ ,_ ,_ ,_ ,P ,_
P ,_ ,P ,P ,P ,P ,P ,_ ,P
_ ,B ,_ ,_ ,_ ,_ ,_ ,R ,_
L ,N ,S ,G ,K ,G ,S ,N ,L