9x9
_ ,_ ,_ ,_ ,k ,_ ,_ ,_ ,_
_ ,_ ,_ ,_ ,_ ,_ ,_ ,_ ,_
_ ,_ ,_ ,_ ,_ ,_ ,_ ,_ ,b
_ ,_ ,_ ,_ ,_ ,_ ,_ ,_ ,_
_ ,_ ,_ ,_ ,_ ,_ ,_ ,_ ,_
_ ,_ ,_ ,_ ,_ ,_ ,_ ,_ ,_
_ ,_ ,_ ,_ ,_ ,_ ,_ ,_ ,_
_ ,_ ,_ ,_ ,G ,r ,_ ,_ ,_
_ ,_ ,_ ,G ,K ,r ,_ ,_ ,_