9x9
l ,n ,s ,g ,k ,g ,s ,n ,l
_ ,r ,_ ,_ ,_ ,_ ,_ ,b ,_
p ,p ,p ,p ,p ,p ,p ,p ,p
_ ,_ ,_ ,_ ,_ ,_ ,_ ,_ ,_
_ ,_ ,_ ,_ ,_ ,_ ,_ ,_ ,_
_ ,_ ,_ ,_ ,_ ,_ ,_ ,_ ,_
P ,P ,P ,P ,P ,P ,P ,P ,P
_ ,B ,_ ,_ ,_ ,_ ,_ ,R ,_
L ,N ,S ,G ,K ,G ,S ,N ,L